11111111111
10000000001
10000000001
10000010001
10000010001
10000100001
10001100001
10011010001
10000000001
10000000001
10000000001
10000000001
11111111111