NO ./includes/assets/IMG_1.xpm
SO ./includes/assets/IMG_2.xpm
EA includes/assets/IMG_3.xpm
WE .xpm



C  50,50,50


F  102,255,25
11111111111111
10000000000001
10000000000001
11111111111111