1111111111
1110000001
1000111001
100110N001
1111111111