NO ./textures/north.xpm
SO ./textures/duck.xpm
WE ./textures/logo_cub3d.xpm
EA ./textures/cobblestone.xpm
C 88,212,255
F 130,50,220
 
 
 
 
 
 
 
 
 
 
 
 
 
                1111111111111 111111111111
                 111111111111 1111111111111111         
                100D00000011 1000000000001
                1001111100011 1000000000001       
                1001    100011 1000000000001
                10001 1100011 10000000001111
                10001   100011 10000000000011
                1000011100011 1000000000001
                10N100000011 1000000000001 
                1010001D1011 1000000000001
                100000000011 1000000000001
                111111111111 1111111111111
 
 
 
 

