NO ./includes/assets/IMG_1.xpm
SO ./includes/assets/IMG_2.xpm
EA includes/assets/IMG_3.xpm
WE .xpm



C  0,255,255


F  102,25,255
11111111111111
10000000000001
10000011000001
100001N0000001
10000000000001
10000000000001
11111111111111