NO ./includes/assets/IMG_1.xpm
SO ./includes/assets/IMG_2.xpm
EA includes/assets/IMG_3.xpm
WE .xpm



C  0,255,255


F  102,25,255
11111111111111111111111111111111111
10000000000000000000000000000000001
10000011000000000000000000000000001
10000100000000000000000000000000001
10000000000000000000000000000000001
10000000000000000000000000000000001
10000000000000000000000000000000001
10000000000000000S00000000000000001
10000000000000000000000000000000001
10000000000000000000000000000000001
1000000000000011D101000000000000001
10000000000000DD0000000000000000001
10000000000000110000000000000000001
1000000000000000000000000000000001
10000000000000000000000000000000001
10000000000000000000000000000000001
11111111111111111111111111111111111