NO ./textures/north.xpm
SO ./textures/duck.xpm
WE ./textures/logo_cub3d.xpm
EA ./textures/cobblestone.xpm


C 88,212,255
F 130,50,220

111111111111111111111111111111111111
10000000000000000000000000000000001
10111101111101111100000000000000001
10000100000100000100000010000000001
10110111110111010100000000000000001
10010000000100000100000000000000001
10111111110101110101111111111100001
10000000000100000100000000000000001
10111111110111110101111111110111001
10000000000100000100000000000100001
10111111000101110101111100011101001
10000001000100000100000100001100001
10111101111101111101110100000110001
10000000000000000000000100000000001
1011111111111111111111D1011111111011111
100000000000000000000000000000000011
10000000000000CCCCCCCCCCCCCCCC00000111111111111111
1011111111111111111111111111111111111111111111
1000000000000000000000000000000000000000000001
1000000000000000000000000S00000000000000000001
10000000000000000000001000000000000000000000001
1000000000000000000001C1000000000000111111111111111
1C00000C00000000000001D10000J0000011
1C00000C0000000000000000000000000011
1C00000C0000000000000000000000000011
1C00000C0000000000000000000000000011
1C00000C0000000000000000000000000C11
11111111111111111111111111111111111