NO ./includes/assets/IMG_1.xpm
SO ./includes/assets/IMG_2.xpm
EA includes/assets/IMG_3.xpm
WE .xpm



C  0,255,255


F  102,25,255
11111111111111111111111111111111111
10000000000000000000000000000000001
10111101111101111100000000000000001
10000100000100000100000000000000001
10110111110111010100000000000000001
10010000000100000100000000000000001
10111111110101110101111111111100001
1000000000010000010000000000S000001
10111111110111110101111111110111001
10000000000100000100000000000100001
1011111100010111010111110001D101001
1000000100010000010000010000DD00001
10111101111101111101110100000110001
10000000000000000000000100000000001
10111111111111111111110101111111101
10000000000000000000000000000000001
11111111111111111111111111111111111
