11111111111
11100000011
10001110011
1001100N011
11111111111