NO ./incs/textures/prateleiras.xpm
SO ./incs/textures/Bookcase.xpm
CL ./incs/textures/Comic.xpm

C 88,212,255
F 130,50,220
DO ./incs/textures/Fusuma.xpm




EN ./incs/textures/j_b.xpm
EA ./incs/textures/Comoda.xpm
WE ./incs/textures/posters.xpm





111111111111111111111111111111111111
10000000000000000000000000000000001
1011110111110111110000000000000001
10000100000100000100000010000000001
10110111110111010100000000000000001
1001000000100000100000000000000001
10111111110101110101111111111100001
1000000000010000010000000000000001
10111111110111110101111111110111001
10000000000100000100000000000100001
10111111000101110101111100011101001
10000001000100000100000100001100001
10111101111101111101110100000110001
10000000000000000000000100000000001
101111111111111111111101011111111011111
100000000000000000000000000000000011
1011111111111111111111111111111111111111111111
100011100000000000000000000000000000000000001
10001010000111111100000000000000000000000001
10001D100001000001001000000000000000000000001
100000000001000001000000000000000111111111111111
10000000000100000100000000000000111
1000000000011111D100000000J00000011
100000000000000000000001D1000000011
10000000000000000000000000000000011
10000000000000000000000000000000011
10000000000000000000000000000000011
10000000000000000000000000000000011
10000000000C00000000000000000000011
1000000000000001D1D1D1D100000000011
100000000000000000N0000000000000011
100000000000C00000C0000000000000011
11111111111111111111111111111111111
