NO ./incs/textures/shelfs.xpm
SO ./incs/textures/eagle.xpm
WE ./incs/textures/wall_2.xpm
EA ./incs/textures/purplestone.xpm


C 88,212,255
F 130,50,220

111111111111111111111111111111111111
10000000000000000000000000000000001
10111101111101111100000000000000001
10000100000100000100000010000000001
10110111110111010100000000000000001
10010000000100000100000000000000001
10111111110101110101111111111100001
10000000000100000100000000000000001
10111111110111110101111111110111001
10000000000100000100000000000100001
10111111000101110101111100011101001
10000001000100000100000100001100001
10111101111101111101110100000110001
10000000000000000000000100000000001
1011111111111111111111D1011111111011111
100000000000000000000000000000000011
10000000000000CCCCCCCCCCCCCCCC00000111111111111111
1011111111111111111111111111111111111111111111
1000000000000000000000000000000000000000000001
100000000000000000000000N00000J00000000000001
1C0C00000000000000001000000000000000000000001
1C0C0000000000000000000000000000000111111111111111
1C0C0000000000000000000000000000111
1C0C0000000000000000000000000000011
1C0C0000000000000000000000000000011
1C0C0000000000000000000000000000011
1C0C0000000000000000000000000000C11
11111111111111111111111111111111111